2
*******
***A***
**AB***
**BAB**
**ABA**
**BAB**
**ABA**
**BAB**