2
*******
***A***
***B***
***C***
***C***
**BDA**
*BDCAD*