2
*******
***A***
**BCD**
**DBD**
**DCC**
**CED**
**EDA**
*CCEBA*