1
*******
***A***
***B***
**ACB**
**CBC**
*ACACB*
*AACBB*