2
*******
***A***
***B***
**ACA**
**CBC**
**BDB**
*ADBDA*