2
*******
***A***
***B***
**CB***
**CD***
**ABC**
**DDA**